1111111111111
1001111100001
1P00C000C0001
1001111100011
1000C000C0101
1111111111111
