1111111111111
1001111100001
1000000000001
1001111100011
10000000000E1
1111111111111
