1111111111111
1E01111100001
1P00C000C0001
100111110000
1000C000C0001
1111111111111
